1111111111111111111111111111111111111111
1000M0000P0000000000000M0111000C00000E11
100M0M000000000CM11100000000000010000C11
1111111111111111111111111111111111111111
1111111111111111111111111111111111111111
1111111111111111111111111111111111111111
1111111111111111111111111111111111111111
1111111111111111111111111111111111111111
1111111111111111111111111111111111111111

